#########
#6     0#
#       #
#   71  #
#3     2#
#########